2121412222
1        2
2        2
2        2
2        3
222      2
1        5
2        2
1        2
2512121312