1141212211
1    1   1
2     11 2
5        2
2    21  3
1222     2
1        2
2    22  4
1        2
1512221231